########################
#.........#....#.......#
#.........#............#
#.........#....#.......#
#.........#....#.......#
#..............#.......#
#.........#....#########
#.........#....#
###########....#
#.........#....##########
#..,,,,...#....#.........#
#..,xx,.................c#
#..,xx,...#....#.........#
#..,,,,...#....#.....####
#.........#....#######
#.........#....#
################
